0 0 1 1 1 1 1 1 1 1 1 0 0 0 0 0
1 1 1 1 1 1 1 1 1 1 1 0 0 0 0 0
1 1 1 1 1 1 1 1 1 1 1 1 0 0 0 0
1 1 1 1 1 1 1 1 1 1 1 1 1 1 0 0
1 1 2 2 2 2 2 2 1 1 1 1 1 1 1 1
1 1 2 1 1 1 1 2 1 1 1 1 1 1 1 1
1 1 2 1 1 1 1 2 1 1 1 1 1 1 1 1
1 1 2 1 1 1 1 2 1 1 1 1 1 1 1 1
2 2 2 1 1 1 1 2 1 1 1 1 1 2 2 2
1 1 1 1 1 1 1 2 1 1 1 1 1 2 1 1
1 1 1 1 1 1 1 2 1 1 1 1 1 2 1 1
1 1 1 1 1 1 1 2 1 1 1 1 1 2 1 1
1 1 1 1 1 1 1 2 2 2 2 2 2 2 1 1
0 0 0 1 1 1 1 1 1 1 1 1 1 1 1 1
0 0 0 0 1 1 1 1 1 1 1 1 1 1 1 1
0 0 0 0 1 1 1 1 1 1 1 1 1 1 1 1

[CHECKPOINTS]
0,7
2,7
2,12
7,12
7,3
12,3
13,7
15,7


//enemy path is 2
//tower grass is 0 
//1 can be used by towers