1111111111111111
0000000000000000
1111111111111111
0000000000111111
0000111110001100
0000111101010101
1010101010010101
1010101010101010
1010101010101010
1010101010101001
0100100001111000
0010101010101011
0000011111000001
1111001010110101
1101010101010101
1110100101010101