1 1 1 1 1 1 1 1 1 1 1 1 1 1 1 1
0 0 0 0 0 0 0 0 0 0 0 0 0 0 0 0
1 1 1 1 1 1 1 1 1 1 1 1 1 1 1 1
0 0 0 0 0 0 0 0 0 0 1 1 1 1 1 1
0 0 0 0 1 1 1 1 1 0 0 0 1 1 0 0
0 0 0 0 1 1 1 1 0 1 0 1 0 1 0 1
1 0 1 0 1 0 1 0 1 0 0 1 0 1 0 1
1 0 1 0 1 0 1 0 1 0 1 0 1 0 1 0
1 0 1 0 1 0 1 0 1 0 1 0 1 0 1 0
1 0 1 0 1 0 1 0 1 0 1 0 1 0 0 1
0 1 0 0 1 0 0 0 0 1 1 1 1 0 0 0
0 0 1 0 1 0 1 0 1 0 1 0 1 0 1 1
0 0 0 0 0 1 1 1 1 1 0 0 0 0 0 1
1 1 1 1 0 0 1 0 1 0 1 1 0 1 0 1
1 1 0 1 0 1 0 1 0 1 0 1 0 1 0 1
1 1 1 0 1 0 0 1 0 1 0 1 0 1 0 1

[CHECKPOINTS]
0,4 
1,4 
2,4 
2,5
